############
#          #
#   O  #####
#   X      #
##         #
#    XO    #
#          #
#   ###    #
#   #      #
# P #      #
############
EASY LEVEL !