#####################
###     ###  #     O#
#O  ##       #    ###
#  P    ##   #      #
#    #####   ####   #
######       #      #
# O##O          #  ##
#  ######       #####
#  #####            #
#  #                #
#     X##X X    ## ##
#    X ## X  ##    ##
#           ##    ###
#          ##O   ####
#####################
EXTRA HARD LEVEL !!!!