##############
###    # O   #
#      #   ###
#   X  #     #
#      #     #
####  X  #   #
#            #
#       ## ###
#   # P     ##
#   #   #   O#
#   #   #    #
#   #   ######
# O #    X   #
#   #        #
##############
HARD LEVEL !!!