##############
#      #    O#
#      #    ##
#   X  #     #
#            #
###   X      #
#            #
#       # ####
#            #
#    P #    O#
##############
MEDIUM LEVEL !